 .S #  .  #  .  #  #  .  .  . 
 .  .  .  #  .  .  .  #  .  . 
 .  .  .  #  #  #  #  #  .  # 
 .  .  .  #  .  .  #  .  .  . 
 #  .  .  .  .  #  .  .  #  # 
 .  .  #  #  .  .  .  .  .  . 
 .  .  .  .  #  .  #  .  .  . 
 .  #  .  .  .  .  .  .  .  . 
 #  .  #  #  .  .  .  .  .  . 
 .  .  .  .  #  .  .  #  . .E